..........
.    .   .
. .  .   .
. .  .   .
...      .
.    .....
...      X
..........