.......................................................................................................................................................
.  .                    .        .     .     .  .           .                          .              .           .              .  .     .           .
.  ....  ..........  .......  ....  .......  .  .  .  ..........  ....  ....  .......  .  .  ....  ....  .......  .  ....  ....  .  ....  .  .......  .
.                 .  .     .  .                    .     .  .     .     .        .  .     .     .     .     .  .  .     .     .     .           .     .
.  ....  ....  .......  ....  .  ....  .......  ..........  .......  .............  .  ..........  ..........  .  .  ..........  ...................  .
.     .     .  .  .        .  .     .        .     .           .  .     .        .  .     .     .        .  .        .           .        .           .
....  ..........  ....  .  .  .......  .......  .  .  ..........  ..........  .  .  .  .......  .  .......  .  ....  .  ..........  .  .  ....  .  ....
.     .              .  .     .              .  .     .  .  .        .  .  .  .        .     .           .  .  .  .  .           .  .  .  .     .     .
.  ..........  ....  ....  .......  ....  .  ....  ....  .  ....  .  .  .  ....  .  .......  .  ..........  ....  .  ....  .  .  .  ....  .  .......  .
.              .  .           .        .  .  .  .                 .     .        .     .              .              .     .  .        .  .  .     .  .
.  .  ..........  .  ....  .  ....  ..........  ....  .  ....  .......  .......  .  .  .............  .  .............  .......  .......  .  .  .  ....
.  .        .           .  .     .     .  .     .     .  .           .  .  .  .  .  .  .              .     .              .        .  .        .  .  .
..........  .  .......  ..........  .  .  ....  .  ................  ....  .  ...................  ....  ...................  .  .  .  .  .  .......  .
.  .        .  .  .     .     .     .  .                          .     .     .        .              .  .        .  .     .  .  .  .  .  .     .     .
.  ....  .  ....  ....  ....  ..........  .  .  .......  ....  .......  .  .......  .  ..........  ....  .  ....  .  ....  .......  .  .  ..........  .
.        .  .  .     .           .     .  .  .     .  .  .     .  .  .     .     .  .     .           .  .  .           .        .  .                 .
....  ....  .  .  ..........  .......  .  ..........  .  .......  .  ..........  .  ....  ....  .......  ....  .......  .  .  .  .............  .  .  .
.  .  .           .  .  .              .  .        .           .  .  .     .  .  .     .           .                 .  .  .  .     .  .  .     .  .  .
.  ....  ..........  .  ..........  .......  ..........  ....  .  .  .  ....  .  .  .  ....  ..........  .  ....  .......  .......  .  .  .  ....  ....
.     .              .              .                       .     .              .  .     .        .     .  .  .        .  .  .  .        .  .     .  .
.  .  ....  .............  ....  .......  ....  ..........  ....  .  .  ..........  .......  .  ....  ....  .  .......  ....  .  .  .............  .  .
.  .        .        .     .        .        .        .        .     .                 .  .  .  .  .  .           .     .              .     .  .     .
....  ..........  .......  .  .  ....  .......  ....  .  ....  ....  ..........  .......  ....  .  .  ...................  ....  .  .......  .  .  ....
.     .  .  .  .           .  .  .     .           .  .  .        .           .  .        .     .     .  .        .  .     .  .  .  .           .     .
.  ....  .  .  .......  .......  .  .......  .  .......  ....  ....  ..........  .......  .  ....  ....  .......  .  .  .  .  ....  .......  ....  ....
.        .     .           .  .        .  .  .  .  .        .  .  .     .  .        .        .     .     .     .     .  .     .           .           .
.  ....  ....  .  .......  .  ....  ....  .......  ....  .  .  .  .  ....  ....  .  ..........  .  .  .  .  .  .  ..........  ....  ....  ....  .......
.  .           .  .              .  .        .     .     .  .     .  .     .     .  .     .     .     .  .  .     .  .           .  .  .  .     .     .
.  ...............................  .  .......  .  .......  ....  .......  ..........  .  ....  ................  .  .............  .  .  ....  ....  .
.        .  .        .     .  .  .     .        .  .  .     .  .  .           .  .     .  .              .     .  .        .     .  .  .     .  .  .  .
.  .  ....  ....  ....  ....  .  ....  .  .  ....  .  ....  .  .  .  .......  .  .......  .......  ..........  .  ....  .  .  ....  .  .  .  ....  .  .
.  .  .  .        .  .  .        .  .  .  .     .     .  .     .     .  .        .     .     .                    .     .  .           .  .  .     .  .
.  .  .  .  .  ....  .  .  .......  .  .  .  ..........  .  ....  ....  .......  ....  ....  .  .  ....  .  .  .......  ....  ....  ....  .  ....  .  .
.  .     .  .  .        .     .           .     .  .           .     .     .  .                 .     .  .  .     .     .        .  .  .  .  .  .     .
....  .......  .  .......  .............  .  ....  ....  ................  .  ....  .  ..........  .  .  .  .......  .  .......  ....  .  ....  ....  .
.     .     .  .        .           .     .  .  .        .  .  .        .           .  .           .  .  .  .     .  .  .              .     .        .
.  ....  .  .  .  .  ....  .......  .  .  .  .  .......  .  .  ....  ....  .  .  .............  .  ....  .  .  .  .  ....  .  .............  ....  ....
.        .  .  .  .     .  .     .     .  .  .  .           .  .           .  .     .  .     .  .     .  .     .           .              .        .  .
.  .......  .  ....  .  .  .  .  .......  ....  ..........  .  .  .  .  ..........  .  ....  .  ....  ..........  ....  .  .......  ....  .......  .  .
.  .              .  .     .  .                 .           .     .  .  .           .           .              .     .  .     .        .     .      X .
.......................................................................................................................................................
